8
8
info.gridworld.actor.Rock
XXXXXXXX
XOOOXXXX
XOOOOOOX
XOOXXOOX
XOOOOOOX
XXOOXXOX
XOOXXOOX
XXXXXXXX
(1, 1)
(7, 1)
(7, 7)